32
18
22 26 26 26 26 26 26 26 26 26 26 26 26 26 26 22 26 26 26 26 26 26 26 26 26 26 26 26 26 26 26 22
23 0  0  0  0  0  0  0  0  0  0  0  0  0  0  22 3  0  0  0  0  0  0  0  0  0  0  0  0  0  0  21                                                                            
23 0  0  0  0  0  0  0  0  0  0  0  0  0  0  22 28 19 19 24 0  0  0  0  0  0  0  0  0  0  0  21                                                                                          
23 0  0  0  0  0  0  0  0  0  0  0  0  0  0  22 0  0  0  0  5  0  0  0  0  0  0  0  0  0  0  21                                                                                          
22 28 19 20 0  0  0  0  0  0  0  0  0  0  0  22 0  0  0  0  19 5  0  4  0  0  0  0  0  0  0  21                                                                                          
23 0  0  0  0  5  0  5  0  0  0  0  0  0  0  22 0  0  0  0  0  30 31 31 31 32 0  0  0  0  0  21                                                                                          
23 0  0  0  0  30 31 32 0  0  0  0  0  0  0  22 0  0  0  0  0  0  0  0  0  0  0  0  4  0  0  21                                                                                          
23 0  0  0  0  0  0  0  0  0  0  0  0  0  0  22 0  0  0  0  0  0  0  0  0  0  0  30 32 0  0  21                                                                                          
23 0  0  0  0  0  0  0  0  0  0  0  0  0  0  22 0  0  0  0  0  0  0  0  0  0  19 0  0  0  0  21                                                                                          
23 0  0  0  0  0  0  0  0  0  4  4  4  0  0  22 0  0  0  0  0  0  4  5  0  0  0  0  0  0  0  21                                                                                         
23 0  0  0  0  0  0  0  0  30 31 31 32 0  0  22 0  0  0  0  0  30 31 31 31 32 0  0  0  0  0  21                                                                                          
23 0  0  0  0  0  0  0  0  0  0  0  0  0  0  22 4  4  0  0  0  4  0  0  0  0  0  0  0  0  0  21                                                                                          
23 0  0  0  0  0  0  0  0  0  0  0  0  0  0  22 28 19 20 0  0  30 32 0  0  0  0  0  0  0  0  21                                                                                          
23 0  0  0  0  5  0  4  0  0  0  0  0  0  0  22 0  0  0  0  0  0  0  0  0  0  0  0  0  0  0  21                                                                                         
23 0  0  0  0  30 31 32 0  0  0  0  0  0  0  22 0  0  0  0  0  0  0  0  0  0  0  0  0  0  0  21                                                                                          
23 0  0  0  0  0  0  0  0  0  0  0  0  0  0  22 0  0  0  0  0  30 31 32 0  0  0  0  0  0  0  21                                                                                          
23 4  4  4  4  4  4  4  0  0  0  0  0  0  0  0  0  0  0  0  4  4  4  0  0  4  4  4  4  4  4  21                                                                                          
27 19 19 19 19 19 19 19 19 19 19 19 19 19 19 19 19 19 19 19 19 19 19 19 19 19 19 19 19 19 19 25                                                                                            21